10 20
|--------||--------|
|...|..-.||...|..-.|
|..-|.@..||..-|.@..|
|......-.||......-.|
|--------||--------|
|--------||--------|
|...|..-.||...|..-.|
|..-|.@..||..-|.@..|
|......-.||......-.|
|--------||--------|
