10 20
|------------------|
|...|..-......|..-.|
|..-|.@......-|....|
|......-.........-.|
|..................|
|..................|
|......-......|..-.|
|..-.........-|....|
|......-...........|
|------------------|
